FFFFFFFFFFFFFFFFFFFFFFFFFFFFFFFFDFFFFFFFFFFFFFF
F~~~~XXXXXXXXXXXXXXXXXXXXXXXXXXXXXXXXXXXXXXXXXF
F~~~~XXXXXXXXXXEXXXXXXXXXXXXXXXXXXXXXXXXXXXXXXF
F~~~~XXXXXXXXXXXXXXXXXXXXXXXXXXXXXXXXXXXXXXXXXF
F~~~~XXXXXXXXXXXXXXXXXXXXXEXXXXXXXXXXXXXXXXXXXF
FXXXXXXXXXXXXXXXXXXXXXXXXXXXXXXXXXXXXXXXXXXFFFF
FXXXXXXXXXXXXXXXXXXXXXXXXXXXXXXXXXXXXXXXXXXF
FXXXXXXXIXXXXXXXXXXXXXXXXXXXXXXFFFFFFFFFFFFF
FXXXXXXXXXXXXXXXXXXXXXXXXXXXXXXXXXXXXXXXXXXF
FXXXXXXXXXXXXXXXXXXXXXXXXXXXXXXXXXHXXXXXXXXF
FXXXXXXXXXXXXXXXXXXXXXXXXXXXXXXXXXXXXXXXXXXF
FXXXXXXXEXXXXXXXXXXXXXXXXXXXXXXXXXXXXXXXXXXFFFF
FXXXXXXXXXXXXXXXXXXXXXXXXXXXXXXXXXXXXXXXXXXXXXF
FXXXXXXXXXXXXXXXXXXXXXPXXXXXXXXXXXXXXXXXXXXXXXF
FXXXXXXXEXXXXXXXXXXXXXXXXXXXXXXXXXXXKXXXXXXXXXF
FXXXXXXXXXXXXXXXXXXXXXXXXXXXXXXXXXXXXXXXXXXXXXF
FFFFFFFFFFFFFFFFFFFFFFFFFFFFFFFFFFFFFFFFFFFFFFF