FFFFFFFFFFFFFFFFFFFFFFFFFFFFFFFFDFFFFFFFFFFFFFF
F~~~~XXXXXXXXXXXXXXXXXXXXXXXXXXXXXXXXXXXXXXXXXF
F~~~~XXXXXXXXXXEXXXXXXXXXXXXXXXXXXXXXXXXXXXXXXF
F~~~~XXXXXXXXXXXXXXXXXXXXXXXXXXXXXXXXXXXXXXXXXF
F~~~~XXXXXXXXXXXXXXXXXXXXXEXXXXXXXXXXXXXXXXXXXF
FXXXXXXXXXXXXXXXXXXXXXXXXXXXXXXXXXXXXXXXXXXFFFF
FXXXXXXXXXXXXXXXXXXXXXXXXXXXXXXXXXXXXXXXXXXF
FXXXXXXXIXXXXXXXXXXXXXXXXXXXXXXFFFFFFFFFFFFF
FXXXXXXXXXXXXXXXXXXXXXXXXXXXXXXXXXXXXXXXXXXF
FXXXXXXXXXXXXXXXXXXXXXXXXXXXXXXXXXHXXXXXXXXF
FXXXXXXXXXXXXXXXXXXXXXXXXXXXXXXXXXXXXXXXXXXF
FXXXXXXXEXXXXXXXXXXXXXXXXXXXXXXXXXXXXXXXFFFF
FXXXXXXXXXXXXXXXXXXXXXXXXXXXXXXXXXXXXXXXXXXF
FXXXXXXXXXXXXXXXXXXXXXPXXXXXXXXXXXXXXXXXXXXF
FXXXXXXXEXXXXXXXXXXXXXXXXXXXXXXXXXXXXXXXXXXF
FXXXXXXXXXXXXXXXXXXXXXXXXXXXXXXXXXXXXXXXXXXF
FFFFFFFFFFFFFFFFFFFFFFFFFFFFFFFFFFFFFFFFFFFF